voting_preference,troll_tweets_pro_democratic,troll_tweets_anti_democratic,troll_tweets_pro_republican,troll_tweets_anti_republican,Total Tweets,vote2012,vote2016,Vote,main_information_sorce
R,14,64,85,18,181,R,O,1,Online
R,21,72,90,23,206,R,R,0,Online
R,25,62,89,22,198,R,R,0,Social Media
R,8,73,96,29,206,R,R,0,Television
R,22,74,82,28,206,R,D,1,Online
R,23,60,85,18,186,R,R,0,Social Media
R,17,75,81,14,187,R,R,0,Social Media
R,17,69,93,22,201,R,R,0,Social Media
R,17,67,88,13,185,R,R,0,Social Media
R,16,72,81,23,192,R,R,0,Print
R,18,76,86,18,198,R,R,0,Online
R,15,78,85,26,204,R,D,1,Social Media
R,16,64,91,25,196,O,R,1,Print
R,20,68,93,28,209,R,R,0,Online
R,25,71,84,17,197,R,R,0,None
R,19,70,95,30,214,R,R,0,Online
R,17,68,92,16,193,R,R,0,Social Media
R,15,58,91,14,178,R,R,0,Social Media
R,16,69,91,21,197,D,R,1,Social Media
R,32,64,92,22,210,D,R,1,None
R,21,70,95,26,212,D,R,1,Print
R,18,66,87,23,194,R,D,1,Social Media
R,18,69,90,16,193,R,R,0,Online
R,22,66,104,25,217,R,D,1,Print
R,17,68,85,16,186,R,R,0,Online
R,13,68,91,26,198,R,R,0,Social Media
R,23,77,83,22,205,R,O,1,Social Media
R,15,74,91,22,202,D,R,1,Social Media
R,20,69,95,16,200,R,R,0,Online
R,15,64,78,17,174,R,O,1,Online
R,26,75,87,25,213,O,R,1,Social Media
R,18,63,101,22,204,R,R,0,None
R,16,64,86,17,183,R,R,0,Social Media
R,17,66,83,21,187,R,R,0,Online
R,12,65,92,27,196,R,O,1,Print
R,14,65,86,18,183,O,R,1,Online
R,9,76,97,11,193,R,R,0,Online
R,13,69,95,23,200,R,R,0,None
R,19,66,94,20,199,R,R,0,Online
R,18,73,83,16,190,R,O,1,Online
R,27,71,92,17,207,R,O,1,Print
R,15,64,92,21,192,R,R,0,Social Media
R,16,67,80,20,183,R,R,0,Social Media
R,19,73,93,20,205,R,R,0,Television
R,15,80,92,19,206,R,R,0,Social Media
R,15,78,85,23,201,R,O,1,None
R,14,74,89,15,192,R,R,0,Television
R,14,70,100,16,200,R,O,1,Social Media
R,17,61,94,29,201,R,R,0,Social Media
R,18,66,84,25,193,R,R,0,Social Media
R,11,69,90,18,188,R,R,0,Social Media
R,17,72,99,14,202,R,R,0,Social Media
R,14,70,90,6,180,D,R,1,Social Media
R,15,70,87,25,197,R,R,0,Social Media
R,19,79,96,21,215,R,R,0,Social Media
R,23,72,88,22,205,R,R,0,Online
R,28,69,89,21,207,R,O,1,Online
R,16,68,94,20,198,O,O,0,Online
R,28,70,99,25,222,R,R,0,Online
R,14,66,86,22,188,D,R,1,Social Media
R,23,77,89,24,213,R,R,0,Social Media
R,33,69,90,20,212,R,O,1,Print
R,20,67,94,24,205,R,R,0,Social Media
R,17,66,98,22,203,O,R,1,Online
R,20,75,98,21,214,O,O,0,Social Media
R,29,64,89,22,204,O,O,0,Online
R,14,68,95,24,201,R,R,0,Social Media
R,27,72,86,14,199,R,R,0,Online
R,27,69,87,10,193,O,R,1,Online
R,22,71,84,23,200,R,R,0,Social Media
R,20,63,84,18,185,R,R,0,None
R,18,68,93,11,190,R,R,0,Online
R,18,61,94,23,196,D,R,1,None
R,23,66,91,17,197,D,R,1,None
R,30,76,86,24,216,R,R,0,Social Media
R,19,71,91,22,203,R,R,0,Social Media
R,13,70,84,24,191,D,R,1,Online
R,16,65,81,11,173,R,R,0,Online
R,21,67,87,14,189,R,R,0,Print
R,18,65,88,25,196,R,R,0,None
R,19,70,85,19,193,R,R,0,Social Media
R,19,74,80,30,203,R,R,0,Print
R,13,71,88,19,191,R,R,0,Online
R,19,67,93,10,189,R,R,0,None
R,24,73,94,24,215,R,R,0,None
R,23,72,98,16,209,R,R,0,None
R,23,74,90,29,216,R,R,0,Social Media
R,18,68,101,29,216,R,R,0,Social Media
R,19,64,92,27,202,R,O,1,Print
R,14,70,89,21,194,R,R,0,Social Media
R,20,72,80,17,189,O,R,1,Social Media
R,21,78,102,20,221,R,D,1,None
R,29,70,97,17,213,O,R,1,Social Media
R,25,72,93,16,206,R,R,0,Social Media
R,18,70,96,13,197,R,R,0,Social Media
R,22,81,95,21,219,R,R,0,Online
R,14,77,94,25,210,R,R,0,Social Media
R,24,69,95,21,209,R,O,1,Social Media
R,25,69,95,17,206,R,D,1,Social Media
R,31,70,87,22,210,R,R,0,None
R,22,71,89,24,206,R,R,0,None
R,18,67,91,21,197,R,R,0,Social Media
R,20,70,86,24,200,R,R,0,Social Media
R,17,67,101,12,197,R,D,1,Print
R,16,65,83,20,184,R,R,0,Online
R,21,74,91,17,203,D,R,1,Social Media
R,16,73,86,23,198,R,R,0,Online
R,21,67,90,27,205,D,D,0,Television
R,22,76,91,23,212,O,R,1,Television
R,20,69,90,23,202,R,R,0,Social Media
R,19,69,75,17,180,R,R,0,Television
R,17,65,78,24,184,R,R,0,None
R,14,70,94,19,197,R,R,0,Social Media
R,24,69,86,17,196,D,R,1,None
R,20,70,90,20,200,R,R,0,Print
R,24,72,94,18,208,R,R,0,Online
R,14,75,89,31,209,R,O,1,Social Media
R,21,72,86,22,201,R,R,0,Social Media
R,23,75,89,16,203,R,O,1,Social Media
R,20,75,98,18,211,R,R,0,None
R,19,55,98,27,199,R,R,0,Social Media
R,16,68,100,15,199,R,R,0,Social Media
R,30,73,98,14,215,R,O,1,Social Media
R,24,64,82,22,192,R,R,0,Online
R,29,65,81,25,200,R,R,0,Print
R,20,71,90,10,191,R,R,0,Social Media
R,17,68,89,21,195,R,R,0,Social Media
R,12,61,83,31,187,R,R,0,Online
R,17,75,80,22,194,R,R,0,Online
R,21,66,96,24,207,R,R,0,None
R,25,72,98,20,215,R,R,0,None
R,21,72,91,17,201,R,D,1,Print
R,14,78,91,14,197,R,R,0,Social Media
R,23,71,89,17,200,R,R,0,Print
R,12,73,88,13,186,R,O,1,None
R,18,76,83,20,197,R,R,0,Online
R,18,68,89,15,190,R,R,0,Online
R,10,62,85,22,179,R,R,0,None
R,25,71,91,17,204,R,R,0,Online
R,17,77,94,17,205,R,R,0,Social Media
R,18,63,89,24,194,R,R,0,None
R,27,75,97,23,222,R,R,0,Online
R,23,70,98,31,222,D,D,0,Social Media
R,19,70,96,20,205,R,R,0,Social Media
R,23,68,83,11,185,R,R,0,Online
R,22,75,82,15,194,R,R,0,Online
R,28,77,90,23,218,R,R,0,Online
R,21,78,91,19,209,R,O,1,Social Media
R,23,65,93,25,206,R,R,0,Online
R,22,74,83,25,204,R,R,0,None
R,18,68,89,31,206,R,R,0,Online
R,20,65,92,21,198,R,R,0,Online
R,28,72,82,20,202,R,O,1,Social Media
R,16,70,91,17,194,R,R,0,None
R,21,74,100,21,216,R,R,0,Online
R,27,79,82,22,210,D,R,1,Social Media
R,19,75,97,28,219,R,R,0,Social Media
R,15,67,95,23,200,R,R,0,Social Media
R,16,71,95,13,195,R,R,0,Print
R,18,77,97,14,206,R,R,0,Online
R,16,76,90,12,194,O,R,1,None
R,19,62,91,25,197,R,R,0,Online
R,18,75,85,13,191,D,R,1,Online
R,19,68,93,17,197,R,R,0,Television
R,22,67,96,14,199,R,R,0,Social Media
R,23,64,91,26,204,R,R,0,Social Media
R,28,68,96,28,220,R,R,0,Television
R,20,73,96,24,213,D,R,1,Online
R,18,77,84,15,194,O,R,1,Online
R,27,71,92,19,209,O,D,1,Online
R,29,70,88,21,208,D,D,0,Online
R,20,69,89,21,199,D,R,1,Online
R,18,75,89,14,196,R,R,0,None
R,11,65,84,19,179,R,R,0,Social Media
R,27,71,95,26,219,R,R,0,Social Media
R,16,75,85,15,191,D,R,1,Online
R,14,75,92,24,205,R,D,1,Social Media
R,35,72,81,18,206,R,R,0,Social Media
R,21,64,88,21,194,R,R,0,Online
R,20,66,89,23,198,R,D,1,Print
R,6,66,87,21,180,R,R,0,Online
R,20,63,89,28,200,R,R,0,Television
R,25,70,95,13,203,R,D,1,Online
R,22,76,93,21,212,R,R,0,None
R,25,58,86,24,193,R,R,0,Social Media
R,30,74,89,20,213,R,R,0,Print
R,26,69,90,17,202,R,R,0,Social Media
R,17,66,88,30,201,R,R,0,Print
R,24,74,89,25,212,R,R,0,None
R,19,73,89,25,206,R,R,0,Social Media
R,17,70,101,14,202,R,O,1,Online
R,6,65,91,18,180,R,O,1,Social Media
R,16,66,93,10,185,O,D,1,Television
R,22,62,87,22,193,R,R,0,Online
R,31,79,91,11,212,R,R,0,Television
R,23,69,91,10,193,D,R,1,Social Media
R,23,66,92,23,204,R,R,0,Social Media
R,15,59,91,12,177,R,O,1,Social Media
R,21,68,100,18,207,O,R,1,None
R,10,67,80,22,179,R,R,0,None
R,22,63,93,20,198,R,R,0,Online
R,23,82,93,24,222,D,R,1,None
R,21,74,86,16,197,R,R,0,Online
R,24,62,90,18,194,R,R,0,None
R,22,76,85,13,196,R,R,0,Social Media
R,24,75,86,13,198,R,O,1,Social Media
R,29,73,79,20,201,R,R,0,None
R,26,72,96,18,212,R,R,0,Social Media
R,20,71,87,23,201,R,O,1,Television
R,14,73,93,15,195,R,R,0,Social Media
R,22,65,89,17,193,R,R,0,None
R,18,67,100,31,216,R,R,0,Online
R,27,65,91,22,205,R,D,1,Online
R,12,69,101,22,204,R,R,0,None
R,18,71,91,15,195,R,O,1,Print
R,22,73,97,30,222,O,R,1,Social Media
R,19,73,91,25,208,D,R,1,Online
R,17,77,92,27,213,R,D,1,None
R,18,73,89,24,204,R,R,0,None
R,23,76,91,19,209,R,O,1,Online
R,24,75,94,17,210,R,O,1,Television
R,23,67,92,16,198,R,R,0,Social Media
R,31,74,82,22,209,R,O,1,Print
R,26,72,96,17,211,R,R,0,Social Media
R,21,71,86,21,199,R,R,0,None
R,17,65,95,21,198,R,R,0,None
R,35,73,89,22,219,O,D,1,Social Media
R,23,70,90,19,202,R,R,0,Social Media
R,17,68,93,21,199,D,R,1,Online
R,21,75,86,16,198,O,O,0,None
R,18,75,90,15,198,D,D,0,Online
R,19,74,87,18,198,D,R,1,Social Media
R,15,57,93,15,180,R,R,0,Social Media
R,21,66,92,21,200,R,R,0,Social Media
R,22,75,83,28,208,R,R,0,Social Media
R,15,66,88,19,188,R,R,0,Social Media
R,4,72,87,22,185,R,R,0,None
R,19,71,87,16,193,R,R,0,Online
R,20,76,90,24,210,O,R,1,None
R,23,66,81,20,190,R,D,1,Television
R,20,70,100,8,198,R,R,0,Social Media
R,22,72,92,22,208,D,R,1,Online
R,15,76,80,23,194,R,R,0,Television
R,24,69,85,22,200,R,R,0,Online
R,24,71,92,20,207,O,R,1,Social Media
R,21,63,79,23,186,R,R,0,Social Media
R,27,73,88,20,208,R,R,0,Online
R,22,71,90,25,208,R,R,0,None
R,21,73,96,14,204,D,R,1,Online
R,21,68,98,24,211,R,R,0,Television
R,22,78,97,22,219,R,R,0,None
R,25,69,97,24,215,D,R,1,Online
R,22,71,88,19,200,R,R,0,Social Media
R,23,69,96,22,210,R,R,0,Social Media
R,14,74,90,23,201,R,O,1,Online
R,18,66,99,20,203,D,R,1,None
R,27,71,92,13,203,D,R,1,Social Media
R,14,73,93,23,203,R,R,0,None
R,21,64,92,17,194,R,R,0,Online
R,22,71,94,13,200,R,R,0,None
R,25,67,92,23,207,R,O,1,Social Media
R,18,77,88,27,210,R,R,0,Social Media
R,21,74,91,21,207,R,O,1,Online
R,11,61,105,24,201,R,D,1,Social Media
R,22,75,85,18,200,R,R,0,Online
R,17,71,93,19,200,R,R,0,Television
R,19,67,92,26,204,D,R,1,Online
R,14,68,95,18,195,O,O,0,Social Media
R,22,64,78,23,187,R,R,0,Social Media
R,23,72,84,17,196,R,O,1,Social Media
R,18,62,91,21,192,D,R,1,Online
R,29,69,85,32,215,R,R,0,Social Media
R,23,72,88,25,208,O,R,1,Online
R,25,70,93,30,218,R,R,0,None
R,30,74,90,28,222,D,R,1,None
R,17,70,86,23,196,R,R,0,Social Media
R,24,82,89,14,209,R,R,0,Television
R,25,66,99,23,213,R,R,0,Social Media
R,20,78,98,20,216,R,R,0,Social Media
R,22,62,88,15,187,R,R,0,Social Media
R,15,65,98,11,189,R,R,0,Online
R,22,65,93,12,192,R,R,0,Online
R,16,62,94,19,191,R,R,0,None
R,24,77,85,24,210,R,R,0,None
R,16,75,82,9,182,R,R,0,Social Media
R,22,77,97,26,222,R,R,0,Online
R,16,67,86,11,180,R,R,0,Online
R,19,70,87,18,194,R,R,0,Television
R,12,76,91,26,205,R,R,0,Social Media
R,21,75,82,24,202,R,R,0,Social Media
R,25,73,93,21,212,R,D,1,Online
R,21,71,97,20,209,R,R,0,Social Media
R,11,64,89,22,186,R,R,0,Social Media
R,17,72,81,18,188,R,O,1,Social Media
R,28,69,87,20,204,O,R,1,Online
R,29,67,87,20,203,O,R,1,Social Media
R,14,78,95,28,215,R,R,0,Online
R,18,66,95,26,205,D,R,1,Television
R,22,71,91,25,209,O,D,1,Social Media
R,22,73,88,22,205,R,R,0,None
R,17,75,89,23,204,R,R,0,Television
R,15,72,93,24,204,R,R,0,Social Media
R,19,80,94,22,215,D,R,1,Online
R,25,72,99,18,214,R,R,0,Print
R,20,68,84,25,197,R,R,0,Print
R,17,71,92,23,203,R,R,0,Social Media
R,17,73,91,18,199,D,R,1,Online
R,28,59,81,18,186,R,R,0,Print
R,18,70,89,15,192,O,R,1,None
R,24,70,87,12,193,O,R,1,Online
R,27,69,84,18,198,R,O,1,Social Media
R,22,70,91,24,207,R,R,0,Online
R,18,60,78,27,183,R,R,0,None
R,20,72,95,23,210,O,R,1,Social Media
R,18,70,97,24,209,R,R,0,Social Media
R,26,68,96,16,206,R,O,1,Social Media
R,19,56,95,13,183,R,R,0,Online
R,28,68,91,18,205,R,R,0,None
R,17,71,91,21,200,R,O,1,Online
R,17,70,89,18,194,R,R,0,Online
R,21,67,86,25,199,O,D,1,Social Media
R,20,72,91,22,205,O,R,1,Online
R,17,65,94,17,193,R,R,0,None
R,12,73,83,27,195,R,D,1,Online
R,20,74,89,17,200,R,R,0,Social Media
R,16,75,88,14,193,R,R,0,None
R,25,74,92,21,212,O,R,1,None
R,15,68,86,22,191,R,R,0,Print
R,26,70,95,12,203,R,R,0,Social Media
R,17,76,87,20,200,R,R,0,Online
R,21,73,96,11,201,R,R,0,Social Media
R,24,72,87,21,204,R,R,0,Online
R,17,76,96,19,208,D,O,1,None
R,23,67,88,17,195,R,R,0,Online
R,20,70,93,15,198,R,R,0,Online
R,14,77,91,19,201,R,R,0,Television
R,19,69,90,15,193,R,D,1,Print
R,28,71,97,28,224,R,R,0,Social Media
R,19,69,91,23,202,R,D,1,Social Media
R,16,76,92,29,213,R,R,0,Social Media
R,20,71,89,22,202,R,R,0,None
R,22,70,88,24,204,R,R,0,Social Media
R,25,67,101,34,227,R,O,1,None
R,26,68,89,12,195,R,R,0,Online
R,21,62,91,10,184,D,R,1,Social Media
R,26,72,92,15,205,R,R,0,Print
R,16,74,91,25,206,R,R,0,None
R,8,63,97,13,181,R,D,1,Online
R,18,72,84,28,202,O,R,1,None
R,17,72,88,27,204,O,R,1,Online
R,8,71,84,32,195,R,D,1,Online
R,23,70,87,10,190,R,R,0,Social Media
R,16,78,92,15,201,R,R,0,None
R,19,72,94,24,209,R,R,0,Online
R,12,77,104,19,212,R,R,0,Social Media
R,23,72,93,24,212,O,R,1,None
R,29,72,89,15,205,R,D,1,Social Media
R,16,67,85,22,190,D,D,0,Social Media
R,19,83,92,21,215,O,R,1,Social Media
R,30,70,95,21,216,R,R,0,Social Media
R,25,68,88,26,207,R,R,0,Print
R,30,72,91,17,210,R,R,0,Online
R,20,72,91,22,205,R,R,0,Online
R,19,74,88,14,195,R,R,0,Print
R,17,65,94,19,195,R,R,0,None
R,27,69,83,12,191,R,D,1,Social Media
R,14,78,100,17,209,R,R,0,None
R,22,68,90,20,200,R,R,0,None
R,20,68,92,25,205,R,O,1,Television
R,31,73,91,18,213,R,R,0,Online
R,17,67,83,20,187,R,D,1,None
R,12,76,93,25,206,R,R,0,Social Media
R,21,72,89,12,194,D,R,1,Social Media
R,20,70,85,20,195,R,R,0,Social Media
R,16,62,92,20,190,R,O,1,Social Media
R,21,68,80,26,195,R,R,0,Social Media
R,19,80,98,20,217,R,O,1,Online
R,17,69,85,16,187,R,R,0,None
R,23,73,89,11,196,R,R,0,Online
R,18,65,99,17,199,R,R,0,Print
R,11,62,83,26,182,R,R,0,Social Media
R,7,74,98,30,209,R,R,0,Social Media
R,17,77,94,27,215,O,R,1,Online
R,27,62,94,16,199,R,R,0,Social Media
R,24,74,79,20,197,R,O,1,Social Media
R,26,72,89,25,212,R,R,0,Print
R,25,68,83,18,194,R,R,0,Television
R,22,79,86,15,202,O,R,1,Print
R,12,65,92,20,189,R,R,0,None
R,21,69,86,15,191,R,R,0,Social Media
D,112,53,42,17,224,D,D,0,Print
D,12,18,21,32,83,R,D,1,None
D,64,62,-12,79,193,D,D,0,None
D,102,38,37,66,243,D,D,0,Online
D,91,65,8,56,220,D,D,0,Social Media
D,96,40,-1,47,182,D,D,0,Print
D,89,25,44,41,199,D,D,0,Online
D,91,13,26,48,178,D,O,1,None
D,80,13,30,55,178,D,D,0,Social Media
D,62,37,26,87,212,D,D,0,Online
D,55,0,6,53,114,O,D,1,None
D,81,9,20,48,158,R,O,1,Print
D,72,79,16,58,225,D,D,0,Online
D,62,36,7,73,178,O,D,1,Television
D,88,67,-14,83,224,D,O,1,Social Media
D,83,73,30,59,245,D,R,1,Social Media
D,109,42,7,35,193,D,D,0,Television
D,58,40,46,59,203,D,D,0,Social Media
D,70,44,40,49,203,D,D,0,Television
D,79,54,14,36,183,D,D,0,Online
D,52,56,26,22,156,D,D,0,Television
D,74,0,39,67,180,D,D,0,None
D,66,41,14,65,186,D,D,0,Social Media
D,37,52,80,50,219,D,D,0,Social Media
D,74,37,31,36,178,O,R,1,None
D,69,45,18,45,177,D,D,0,Television
D,103,58,21,30,212,D,D,0,Social Media
D,68,37,19,39,163,O,D,1,Social Media
D,91,71,46,48,256,O,D,1,None
D,83,49,45,51,228,D,D,0,Social Media
D,55,8,23,49,135,D,O,1,Social Media
D,87,36,17,62,202,D,D,0,Television
D,78,51,32,4,165,O,O,0,Social Media
D,83,43,8,92,226,D,D,0,Print
D,93,13,21,87,214,D,D,0,Social Media
D,82,2,16,59,159,D,R,1,None
D,112,39,-8,22,165,D,D,0,Social Media
D,82,54,9,66,211,R,D,1,None
D,55,26,-2,3,82,D,R,1,Online
D,95,48,39,79,261,D,D,0,Print
D,56,52,-3,69,174,R,D,1,None
D,42,59,18,23,142,O,R,1,Social Media
D,64,52,1,64,181,D,D,0,Print
D,65,45,22,48,180,R,O,1,Online
D,68,9,11,53,141,R,D,1,Social Media
D,112,30,67,46,255,O,D,1,Online
D,113,57,13,55,238,D,D,0,Online
D,95,49,35,71,250,O,R,1,Online
D,55,22,28,34,139,D,R,1,Social Media
D,80,46,34,-11,149,D,O,1,Television
D,90,38,40,83,251,D,D,0,Social Media
D,77,65,10,9,161,D,O,1,Social Media
D,83,39,-3,59,178,D,D,0,Social Media
D,61,32,33,51,177,R,D,1,Social Media
D,54,35,1,57,147,R,R,0,Print
D,108,22,47,73,250,O,D,1,Television
D,85,66,-2,50,199,D,O,1,Online
D,72,43,-31,59,143,O,D,1,Social Media
D,87,28,-1,31,145,D,D,0,None
D,121,48,10,55,234,D,D,0,Online
D,87,57,58,48,250,D,D,0,Television
D,108,32,36,64,240,D,D,0,Social Media
D,107,34,51,65,257,R,D,1,None
D,72,39,-6,43,148,D,O,1,Social Media
D,95,0,42,25,162,O,R,1,Social Media
D,67,43,8,26,144,D,D,0,Social Media
D,51,41,37,33,162,D,D,0,Social Media
D,56,35,-19,55,127,O,D,1,Television
D,77,20,40,35,172,O,D,1,None
D,116,61,14,52,243,D,D,0,Television
D,82,31,16,74,203,D,D,0,Social Media
D,64,43,46,40,193,D,D,0,None
D,85,82,27,63,257,D,D,0,Online
D,94,28,22,46,190,O,D,1,Online
D,54,27,36,43,160,D,O,1,Social Media
D,59,43,2,41,145,D,D,0,Online
D,41,34,-7,51,119,D,D,0,Print
D,55,30,42,40,167,D,R,1,Social Media
D,62,48,48,71,229,D,D,0,None
D,74,45,30,49,198,D,D,0,Social Media
D,108,19,20,63,210,R,D,1,Online
D,98,12,48,82,240,O,D,1,Online
D,85,52,23,60,220,D,D,0,Social Media
D,69,23,28,19,139,D,D,0,Social Media
D,79,21,22,24,146,D,D,0,Social Media
D,91,65,35,42,233,O,D,1,Social Media
D,70,42,-3,68,177,R,D,1,Online
D,101,29,11,44,185,O,O,0,Social Media
D,102,55,16,44,217,D,D,0,Social Media
D,57,66,-12,59,170,O,D,1,Online
D,65,60,35,51,211,D,D,0,Social Media
D,104,20,24,50,198,O,D,1,Social Media
D,46,28,6,46,126,O,D,1,Social Media
D,88,46,27,72,233,O,D,1,Print
D,85,13,23,48,169,D,D,0,Online
D,144,32,6,57,239,R,D,1,Online
D,25,40,21,60,146,R,O,1,Social Media
D,63,39,5,56,163,D,D,0,Online
D,93,44,31,56,224,D,O,1,Online
D,113,44,-8,29,178,D,O,1,Social Media
D,97,58,23,96,274,D,D,0,Social Media
D,51,39,37,60,187,D,D,0,Social Media
D,125,23,24,25,197,O,D,1,Social Media
D,45,38,4,83,170,D,D,0,Online
D,58,36,-2,45,137,D,D,0,Online
D,79,41,-12,79,187,D,D,0,Television
D,125,70,29,69,293,D,D,0,None
D,90,51,24,44,209,D,D,0,None
D,95,76,21,51,243,D,D,0,Social Media
D,115,62,34,34,245,O,D,1,Online
D,100,76,-7,12,181,O,D,1,Social Media
D,56,13,31,32,132,R,D,1,Print
D,94,26,-6,51,165,D,D,0,None
D,78,29,14,43,164,D,R,1,Social Media
D,116,34,-22,65,193,D,D,0,Social Media
D,75,32,-12,44,139,D,D,0,None
D,49,49,6,27,131,D,D,0,Television
D,90,15,26,33,164,D,O,1,None
D,87,29,25,2,143,D,D,0,Print
D,80,29,39,67,215,O,D,1,Online
D,59,33,29,60,181,D,D,0,Online
D,63,28,29,55,175,D,D,0,Print
D,80,64,1,52,197,D,D,0,Social Media
D,101,55,-3,58,211,D,D,0,Social Media
D,73,45,8,37,163,O,O,0,Social Media
D,63,12,-16,23,82,O,D,1,Online
D,26,99,18,51,194,O,D,1,Online
D,90,59,15,40,204,D,D,0,None
D,89,65,10,59,223,O,D,1,Social Media
D,106,2,24,64,196,D,D,0,Print
D,109,36,-9,26,162,O,D,1,Print
D,77,55,-18,19,133,O,O,0,Social Media
D,106,48,31,75,260,O,D,1,Online
D,80,52,0,26,158,R,D,1,Online
D,66,52,2,27,147,D,R,1,Online
D,63,31,11,50,155,R,O,1,Social Media
D,73,35,5,23,136,R,D,1,None
D,85,21,45,57,208,D,R,1,Online
D,79,62,41,35,217,O,D,1,Social Media
D,84,1,21,77,183,D,O,1,Online
D,84,34,16,19,153,D,D,0,Television
D,94,56,8,65,223,D,D,0,Social Media
D,75,36,40,42,193,D,D,0,Print
D,113,69,25,92,299,O,R,1,Social Media
D,89,57,24,41,211,D,D,0,Print
D,56,23,-10,29,98,D,O,1,Television
D,74,39,38,38,189,O,D,1,Online
D,90,40,8,51,189,D,O,1,Television
D,72,45,27,46,190,D,O,1,Print
D,87,29,21,37,174,D,D,0,Social Media
D,89,28,46,48,211,R,D,1,Print
D,106,35,47,53,241,D,D,0,Online
D,67,58,46,1,172,D,D,0,Online
D,80,62,18,18,178,D,O,1,Social Media
D,69,28,18,17,132,O,R,1,None
D,57,41,22,66,186,R,O,1,Online
D,43,20,30,45,138,D,O,1,Online
D,84,25,19,46,174,O,D,1,None
D,92,28,-7,79,192,O,D,1,Social Media
D,93,14,2,28,137,O,D,1,Television
D,52,0,-2,93,143,D,D,0,Social Media
D,57,55,7,45,164,D,D,0,Social Media
D,57,48,46,21,172,D,O,1,Television
D,66,23,18,32,139,D,D,0,None
D,83,59,33,44,219,D,D,0,Social Media
D,92,76,18,61,247,O,D,1,Social Media
D,64,-11,39,45,137,O,D,1,None
D,23,63,-16,32,102,O,D,1,Social Media
D,99,65,11,28,203,D,D,0,Social Media
D,92,43,18,64,217,D,R,1,Online
D,66,30,28,48,172,D,D,0,Television
D,59,18,15,56,148,D,D,0,Social Media
D,74,22,16,47,159,D,R,1,Television
D,82,27,43,20,172,D,D,0,None
D,94,-2,32,70,194,D,D,0,Social Media
D,108,27,13,52,200,O,D,1,None
D,63,60,19,81,223,O,R,1,Online
D,86,25,34,85,230,D,O,1,Social Media
D,107,71,-12,53,219,D,R,1,None
D,62,39,37,45,183,D,D,0,Social Media
D,76,42,47,-1,164,R,D,1,Online
D,45,50,8,50,153,O,R,1,Print
D,86,21,21,47,175,O,D,1,Online
D,67,25,-11,79,160,R,D,1,Social Media
D,62,32,18,38,150,R,D,1,Television
D,64,75,25,72,236,D,D,0,None
D,89,49,5,36,179,D,O,1,Television
D,37,38,18,42,135,D,D,0,Social Media
D,71,18,1,56,146,D,R,1,Television
D,60,38,18,66,182,D,D,0,Television
D,61,48,15,47,171,D,D,0,Social Media
D,89,33,30,71,223,D,D,0,Social Media
D,87,22,35,82,226,O,D,1,Online
D,78,21,53,45,197,D,D,0,None
D,91,36,37,27,191,D,O,1,Social Media
D,68,47,12,48,175,R,O,1,Social Media
D,40,59,16,70,185,O,R,1,None
D,103,13,55,38,209,D,O,1,None
D,75,24,-4,51,146,D,D,0,Social Media
D,73,-1,18,62,152,R,D,1,Social Media
D,83,42,68,44,237,R,D,1,Social Media
D,95,54,12,36,197,D,D,0,Social Media
D,89,45,-4,46,176,O,D,1,Television
D,99,65,26,67,257,R,R,0,Online
D,81,52,-5,20,148,O,D,1,Online
D,70,28,-8,32,122,R,D,1,Online
D,74,69,16,35,194,D,O,1,None
D,96,49,-4,22,163,D,D,0,Social Media
D,63,52,11,36,162,D,D,0,Social Media
D,61,22,45,103,231,D,D,0,Television
D,86,35,59,25,205,D,D,0,Social Media
D,92,16,6,20,134,O,D,1,Online
D,46,39,11,27,123,D,D,0,None
D,96,67,25,40,228,D,D,0,Social Media
D,80,31,-1,22,132,R,D,1,Social Media
D,76,41,20,67,204,D,D,0,Television
D,102,56,-1,47,204,D,D,0,Television
D,110,8,4,19,141,O,D,1,Television
D,57,13,18,36,124,O,D,1,None
D,100,21,18,45,184,D,D,0,Social Media
D,67,46,36,52,201,D,D,0,Social Media
D,83,42,12,71,208,D,D,0,Social Media
D,90,65,31,46,232,D,D,0,Print
D,83,15,-14,18,102,D,D,0,Social Media
D,51,31,25,59,166,D,O,1,Social Media
D,70,-2,37,39,144,O,D,1,Online
D,111,72,19,28,230,D,O,1,Online
D,83,62,17,73,235,D,D,0,Social Media
D,63,27,12,29,131,D,D,0,Online
D,67,35,23,73,198,D,D,0,Online
D,101,37,37,47,222,D,D,0,Social Media
D,87,76,39,69,271,D,D,0,Print
D,62,41,25,65,193,D,D,0,Online
D,80,48,10,46,184,O,D,1,Print
D,92,54,55,90,291,D,D,0,Print
D,114,54,40,61,269,D,O,1,Social Media
D,62,7,2,37,108,D,D,0,Social Media
D,72,55,24,46,197,D,D,0,Online
D,100,22,-13,46,155,D,D,0,Social Media
D,71,39,-13,77,174,D,D,0,Online
D,109,1,4,76,190,D,D,0,Social Media
D,101,44,21,81,247,D,D,0,Social Media
D,47,20,9,89,165,D,D,0,Social Media
D,88,-4,45,56,185,D,D,0,Online
D,52,7,62,52,173,D,D,0,Social Media
D,51,12,38,71,172,D,D,0,Social Media
D,81,51,45,63,240,D,O,1,Social Media
D,81,46,37,63,227,O,D,1,None
D,79,54,42,47,222,R,D,1,Online
D,105,29,69,76,279,D,R,1,Social Media
D,86,44,6,62,198,D,D,0,Online
D,67,48,-4,71,182,O,R,1,Social Media
D,82,38,72,48,240,D,D,0,Online
D,70,18,9,50,147,D,D,0,Social Media
D,79,63,-6,32,168,D,D,0,Social Media
D,57,73,-1,67,196,D,D,0,Social Media
D,78,80,35,25,218,D,D,0,Social Media
D,82,58,9,23,172,D,D,0,Social Media
D,66,36,12,75,189,O,D,1,Social Media
D,81,37,14,-4,128,D,D,0,Social Media
D,67,34,38,62,201,D,R,1,Social Media
D,67,35,19,26,147,D,O,1,Social Media
D,76,39,38,71,224,D,D,0,Online
D,90,1,22,56,169,D,D,0,Online
D,76,40,43,52,211,O,D,1,None
D,84,45,36,61,226,R,D,1,None
D,99,21,30,55,205,O,D,1,None
D,74,5,34,39,152,D,D,0,Social Media
D,78,33,-17,27,121,D,R,1,Social Media
D,90,-22,18,53,139,D,R,1,Online
D,55,73,12,40,180,D,O,1,Online
D,91,54,-11,62,196,D,D,0,Online
D,69,20,24,28,141,D,D,0,Social Media
D,57,40,32,18,147,O,D,1,Social Media
D,45,37,31,59,172,D,D,0,None
D,66,7,6,77,156,R,O,1,Social Media
D,57,22,27,55,161,O,R,1,None
D,56,59,28,44,187,O,D,1,Social Media
D,113,17,57,50,237,D,D,0,Social Media
D,56,25,-2,74,153,D,D,0,Online
D,100,25,34,39,198,D,D,0,Print
D,91,65,13,51,220,D,O,1,None
D,62,36,25,49,172,D,D,0,Social Media
D,68,51,-3,52,168,D,D,0,None
D,72,55,2,72,201,D,O,1,Online
D,84,32,-11,59,164,D,D,0,Social Media
D,73,17,18,53,161,D,O,1,Social Media
D,97,43,24,18,182,D,D,0,Social Media
D,74,33,15,49,171,D,D,0,None
D,37,69,3,62,171,O,R,1,Online
D,78,30,32,56,196,O,D,1,Print
D,43,34,38,31,146,D,D,0,Print
D,99,54,14,37,204,R,O,1,None
D,65,27,48,36,176,D,D,0,Online
D,58,40,-6,30,122,O,O,0,Online
D,68,50,34,69,221,D,D,0,Social Media
D,92,32,36,68,228,O,D,1,Social Media
D,42,16,3,67,128,D,D,0,Online
D,85,46,32,38,201,D,D,0,Television
D,61,34,34,47,176,D,D,0,Social Media
D,80,0,43,59,182,D,O,1,Social Media
D,94,45,28,68,235,D,D,0,Social Media
D,91,43,2,49,185,R,D,1,Television
D,110,6,9,43,168,D,O,1,Online
D,83,29,10,4,126,O,D,1,Social Media
D,66,36,40,46,188,O,D,1,Online
D,123,29,8,34,194,D,D,0,Online
D,74,51,-3,59,181,D,D,0,Online
D,96,8,30,41,175,D,R,1,None
D,99,21,37,62,219,R,D,1,Print
D,89,31,62,45,227,O,D,1,Social Media
D,109,69,36,34,248,D,R,1,Social Media
D,76,37,20,7,140,O,O,0,Social Media
D,55,20,23,33,131,D,R,1,Social Media
D,73,71,2,58,204,D,D,0,Social Media
D,69,35,64,41,209,D,D,0,Online
D,87,51,4,57,199,O,D,1,None
D,61,62,23,0,146,D,D,0,Social Media
D,94,48,35,53,230,D,O,1,Television
D,57,66,-11,45,157,D,O,1,Online
D,115,24,39,44,222,D,D,0,None
D,109,72,26,71,278,D,D,0,Social Media
D,71,4,17,57,149,R,D,1,Social Media
D,83,20,29,54,186,O,O,0,None
D,73,28,11,90,202,D,D,0,None
D,56,45,-25,46,122,D,D,0,Television
D,27,31,33,64,155,O,D,1,Social Media
D,79,52,11,43,185,D,D,0,None
D,79,48,51,39,217,O,O,0,Television
D,113,54,3,67,237,D,O,1,Print
D,40,70,34,47,191,D,D,0,Social Media
D,67,11,31,35,144,D,O,1,Social Media
D,98,59,19,43,219,D,O,1,Online
D,87,35,-3,46,165,D,D,0,Social Media
D,82,24,24,60,190,D,D,0,None
D,68,4,-7,50,115,O,O,0,Television
D,84,23,5,52,164,O,D,1,Print
D,75,34,5,87,201,D,D,0,Online
D,82,1,45,15,143,D,D,0,Television
D,68,33,-12,43,132,O,D,1,Online
D,104,50,3,48,205,D,D,0,Online
D,101,14,-7,22,130,D,D,0,Print
D,107,40,28,102,277,D,D,0,Social Media
D,73,13,30,39,155,D,D,0,Social Media
D,74,39,55,71,239,D,O,1,None
D,73,58,5,39,175,O,D,1,Online
D,107,-4,53,35,191,D,O,1,Online
D,74,86,30,30,220,O,D,1,Online
D,82,17,24,29,152,D,O,1,Online
D,88,59,36,-3,180,D,D,0,None
D,94,82,0,66,242,O,D,1,Online
D,75,21,16,41,153,D,R,1,Online
D,127,26,7,54,214,O,D,1,Social Media
D,61,60,63,44,228,D,D,0,Social Media
D,51,24,4,54,133,D,D,0,None
D,81,21,22,32,156,D,O,1,Television
D,115,72,30,46,263,D,D,0,Social Media
D,81,75,-25,60,191,D,O,1,Social Media
D,82,35,33,59,209,R,O,1,Social Media
D,97,86,-18,49,214,D,D,0,Television
D,78,78,28,17,201,D,D,0,Social Media
D,82,39,-15,62,168,D,D,0,Social Media
D,104,24,7,63,198,O,O,0,Online
D,82,27,22,84,215,D,O,1,Online
D,65,68,6,16,155,D,D,0,Social Media
D,88,51,-4,56,191,O,O,0,Television
D,58,53,58,48,217,O,O,0,Online
D,51,40,24,75,190,D,O,1,None
D,78,44,60,54,236,O,D,1,Social Media
D,58,30,7,25,120,D,D,0,Online
D,92,63,10,36,201,D,D,0,Social Media
D,77,33,59,61,230,O,D,1,Television
D,65,80,21,33,199,D,D,0,Online
D,112,52,19,5,188,O,O,0,Print
D,78,60,44,87,269,D,O,1,None
D,108,70,7,57,242,D,D,0,Social Media
D,78,39,-7,66,176,D,D,0,None
D,73,5,27,35,140,D,D,0,Online
D,87,28,11,43,169,D,O,1,Online
D,101,52,17,8,178,D,D,0,Social Media
D,134,64,30,83,311,D,D,0,None
D,59,44,-12,65,156,R,D,1,Social Media
D,76,57,-11,31,153,D,D,0,Print
D,102,59,43,55,259,O,O,0,Online
D,87,61,20,62,230,D,D,0,Television
D,76,55,40,30,201,D,D,0,Print
D,54,36,17,31,138,D,D,0,Television
D,74,60,31,62,227,O,D,1,Television
D,76,30,29,59,194,O,O,0,Online
D,78,47,4,66,195,R,D,1,Online
D,112,30,45,45,232,D,O,1,Social Media
D,71,50,37,40,198,D,D,0,None
D,48,50,23,70,191,D,D,0,Online
D,90,38,20,60,208,D,D,0,Online
D,78,41,66,61,246,D,D,0,None
D,76,49,-13,6,118,O,O,0,Online
D,93,17,0,13,123,D,O,1,Television
D,22,60,54,41,177,D,D,0,None
D,69,45,17,46,177,D,O,1,Online
D,77,51,-15,68,181,O,D,1,Social Media
D,92,37,12,54,195,D,D,0,Online
D,75,2,33,37,147,D,O,1,None
D,60,55,43,30,188,D,D,0,Social Media
D,87,35,30,97,249,D,D,0,None
D,80,52,8,68,208,O,R,1,Social Media
D,82,81,-11,59,211,D,D,0,Television
D,103,17,52,70,242,D,D,0,Social Media
D,69,67,19,47,202,O,D,1,Social Media
D,55,33,8,28,124,D,D,0,Social Media
D,54,39,9,36,138,D,D,0,Print
I,30,55,59,39,183,D,D,0,Social Media
I,26,55,36,76,193,D,O,1,Social Media
I,40,48,47,38,173,R,D,1,Social Media
I,58,61,63,43,225,D,R,1,Social Media
I,39,65,56,55,215,D,R,1,Online
I,48,58,55,47,208,R,R,0,Online
I,29,44,52,33,158,R,R,0,Online
I,38,56,43,52,189,O,D,1,Online
I,46,64,49,40,199,R,R,0,Social Media
I,36,53,42,37,168,D,D,0,Social Media
I,48,54,58,39,199,D,R,1,Social Media
I,47,48,54,62,211,R,R,0,Social Media
I,34,66,45,48,193,D,D,0,Print
I,32,53,62,55,202,O,R,1,Television
I,64,92,65,44,265,D,R,1,Social Media
I,38,70,60,49,217,R,D,1,Social Media
I,40,58,60,48,206,D,D,0,Print
I,39,60,45,69,213,D,D,0,Social Media
I,34,53,61,80,228,O,D,1,None
I,31,63,38,56,188,O,D,1,Television
I,29,60,60,39,188,R,R,0,Online
I,49,43,64,46,202,D,R,1,Television
I,30,42,54,50,176,D,D,0,Social Media
I,47,66,49,53,215,R,D,1,Social Media
I,54,37,45,41,177,R,R,0,Online
I,52,56,37,55,200,D,D,0,Online
I,39,77,48,56,220,D,O,1,Social Media
I,35,43,48,47,173,D,R,1,Television
I,29,63,62,54,208,R,D,1,Television
I,40,76,39,31,186,R,R,0,None
I,38,65,49,51,203,D,D,0,None
I,42,73,46,57,218,D,R,1,Social Media
I,34,50,47,45,176,O,D,1,Online
I,46,66,57,44,213,D,D,0,Social Media
I,47,62,50,48,207,D,R,1,None
I,51,74,51,68,244,D,D,0,Online
I,62,85,55,46,248,D,D,0,Online
I,42,61,34,49,186,O,D,1,Print
I,34,71,49,37,191,D,D,0,None
I,39,56,51,60,206,O,D,1,Social Media
I,24,56,47,45,172,D,O,1,Television
I,41,54,58,65,218,D,D,0,Social Media
I,36,46,36,38,156,D,D,0,Social Media
I,44,61,22,55,182,R,O,1,Social Media
I,37,60,38,34,169,O,R,1,Online
I,26,67,55,64,212,D,D,0,Online
I,40,58,68,53,219,R,O,1,Online
I,26,51,66,61,204,D,D,0,Social Media
I,49,59,36,56,200,R,D,1,Social Media
I,22,78,42,69,211,D,R,1,Social Media
I,39,65,61,69,234,R,D,1,None
I,45,63,50,38,196,D,R,1,Television
I,25,71,55,57,208,D,O,1,None
I,54,78,57,42,231,D,D,0,Social Media
I,31,77,61,48,217,R,D,1,Social Media
I,35,56,66,37,194,D,R,1,Social Media
I,42,59,51,50,202,D,D,0,Social Media
I,37,56,50,36,179,R,R,0,Social Media
I,30,58,30,43,161,D,D,0,Print
I,44,65,58,50,217,R,O,1,Television
I,35,55,49,43,182,R,R,0,Social Media
I,45,48,36,50,179,O,O,0,Online
I,35,58,51,60,204,O,R,1,Online
I,30,74,54,45,203,O,O,0,Online
I,39,79,37,54,209,D,D,0,Social Media
I,46,56,45,47,194,R,D,1,Social Media
I,42,68,51,53,214,R,D,1,Social Media
I,39,59,38,53,189,O,O,0,Print
I,21,59,50,57,187,R,O,1,Social Media
I,55,53,51,53,212,D,R,1,Social Media
I,40,44,66,34,184,O,D,1,None
I,31,78,63,37,209,D,O,1,Social Media
I,38,68,43,62,211,O,R,1,Social Media
I,43,42,67,43,195,R,O,1,Social Media
I,25,57,57,53,192,R,D,1,Social Media
I,47,76,32,49,204,R,R,0,None
I,42,61,40,51,194,D,R,1,Print
I,52,62,42,69,225,O,O,0,Social Media
I,50,68,48,36,202,D,D,0,Print
I,35,70,45,63,213,R,R,0,Online
I,35,66,38,54,193,R,R,0,Social Media
I,30,64,37,52,183,D,R,1,Social Media
I,36,75,63,43,217,O,R,1,Online
I,49,77,52,59,237,D,R,1,Social Media
I,58,62,51,54,225,D,D,0,Online
I,49,58,50,52,209,D,D,0,Online
I,22,60,58,40,180,O,D,1,Television
I,48,63,55,59,225,D,D,0,Social Media
I,50,53,54,47,204,O,R,1,Social Media
I,46,66,74,46,232,D,D,0,Social Media
I,31,47,45,62,185,D,D,0,Print
I,51,82,58,57,248,R,D,1,Online
I,47,35,63,44,189,O,O,0,Online
I,47,62,53,55,217,D,D,0,Television
I,36,59,37,41,173,R,O,1,Online
I,48,65,46,58,217,O,R,1,Social Media
I,41,56,55,42,194,R,R,0,None
I,39,84,45,32,200,D,O,1,Social Media
I,55,59,52,67,233,O,R,1,Social Media
I,48,60,45,46,199,O,R,1,None
I,11,71,55,57,194,O,R,1,Online
I,36,67,64,39,206,D,D,0,None
I,25,62,43,49,179,R,R,0,Online
I,46,58,38,57,199,D,O,1,Online
I,36,58,43,60,197,R,D,1,Social Media
I,49,46,49,57,201,R,R,0,Social Media
I,45,66,43,56,210,R,R,0,Social Media
I,40,64,37,48,189,D,D,0,None
I,39,50,67,54,210,D,D,0,Television
I,36,58,45,58,197,D,D,0,Social Media
I,42,73,59,37,211,O,R,1,Television
I,29,73,40,48,190,O,D,1,Print
I,47,48,46,43,184,D,R,1,Online
I,36,68,54,36,194,R,R,0,Social Media
I,33,61,48,62,204,R,D,1,Television
I,37,64,58,61,220,R,D,1,Social Media
I,59,51,55,47,212,R,R,0,Print
I,22,58,51,43,174,R,D,1,None
I,37,39,47,61,184,D,D,0,Print
I,41,53,37,50,181,O,R,1,Social Media
I,35,57,42,42,176,R,O,1,Online
I,36,73,38,45,192,R,O,1,Social Media
I,44,49,48,29,170,O,O,0,Television
I,42,63,50,47,202,O,D,1,Television
I,33,61,56,73,223,D,R,1,Television
I,46,46,44,47,183,O,R,1,Television
I,42,63,41,41,187,O,D,1,None
I,47,76,50,59,232,D,O,1,Print
I,27,69,47,54,197,D,D,0,Print
I,32,71,49,54,206,R,R,0,Social Media
I,38,58,75,44,215,D,D,0,Online
I,50,70,61,47,228,D,R,1,Television
I,35,36,43,55,169,O,R,1,Online
I,30,47,59,39,175,R,R,0,None
I,48,58,43,57,206,D,D,0,Social Media
I,45,61,33,55,194,D,D,0,Television
I,28,65,63,40,196,D,D,0,Online
I,60,67,51,53,231,O,O,0,Online
I,55,55,51,41,202,D,R,1,None
I,26,55,43,51,175,R,D,1,None
I,62,57,62,52,233,R,O,1,Online
I,23,54,52,44,173,D,R,1,Social Media
I,41,59,63,40,203,D,R,1,Social Media
I,29,69,53,44,195,D,D,0,None
I,36,65,56,46,203,R,R,0,Online
I,37,56,41,47,181,O,D,1,Social Media
I,43,53,52,44,192,D,D,0,Online
I,29,59,39,43,170,D,D,0,Online
I,12,58,26,58,154,D,D,0,Online
I,39,72,59,38,208,D,D,0,Social Media
O,23,17,74,38,152,R,O,1,Social Media
O,32,30,64,36,162,O,D,1,Social Media
O,22,46,63,24,155,O,O,0,Online
O,38,47,64,41,190,O,O,0,Social Media
O,30,33,42,28,133,O,O,0,Online
O,36,38,50,27,151,R,R,0,None
O,20,58,53,26,157,O,O,0,Print
O,28,29,58,31,146,R,D,1,Online
O,33,58,64,24,179,O,O,0,Social Media
O,29,43,72,11,155,O,R,1,Television
O,47,50,76,20,193,O,O,0,Social Media
O,10,35,60,32,137,R,O,1,Online
O,38,29,66,46,179,O,O,0,None
O,30,44,57,37,168,D,O,1,Online
O,39,44,62,39,184,O,O,0,Online
O,29,36,69,35,169,O,O,0,Social Media
O,3,31,65,38,137,O,O,0,Social Media
O,34,53,55,44,186,O,O,0,Online
O,28,27,67,20,142,O,O,0,Social Media
O,20,54,68,14,156,D,R,1,Online
O,23,34,54,29,140,O,O,0,None
O,31,21,65,20,137,O,D,1,Social Media
O,55,62,70,13,200,R,R,0,Social Media
O,32,44,68,34,178,O,D,1,Online
O,20,29,58,17,124,O,O,0,Television
O,49,36,68,61,214,O,R,1,Social Media
O,26,32,73,31,162,O,O,0,None
O,22,43,50,37,152,O,O,0,Social Media
O,18,41,38,38,135,D,O,1,Social Media
O,23,28,69,20,140,O,O,0,Online
O,49,43,52,29,173,R,D,1,None
O,39,33,53,19,144,D,R,1,Social Media
O,37,46,68,34,185,O,R,1,Television
O,31,46,46,38,161,D,O,1,Online
O,33,40,63,29,165,R,O,1,Online
O,36,32,84,6,158,O,O,0,Online
O,32,35,49,39,155,O,R,1,Print
O,32,30,56,24,142,D,O,1,Social Media
O,40,48,65,45,198,O,O,0,Print
O,28,54,62,33,177,O,O,0,None
O,33,41,49,25,148,O,O,0,Social Media
O,21,43,62,22,148,D,O,1,Social Media
O,46,38,57,32,173,R,O,1,Social Media
O,44,42,50,18,154,D,O,1,Print
O,12,59,70,36,177,D,D,0,None
O,28,43,77,36,184,O,O,0,Social Media
O,35,53,45,32,165,O,O,0,Social Media
O,35,42,71,40,188,O,R,1,Online
O,38,26,62,20,146,O,O,0,Online
O,26,28,65,21,140,O,R,1,Social Media
